...###
..#..#.####
.##..###..#
##........#
#...@..#..#
###.......#
..#..#....#
.##.##.#.##
.#.##...##
.#.....##
.#######